#########################################################################
#boolean
boolean-format-yesno=top ? "是" : "否"

#date
date-format=yyyy-MM-dd HH:mm:ss.SSS
date-format-timestamp=yyyy-MM-dd HH:mm:ss.SSS
date-format-datetime=yyyy-MM-dd HH:mm:ss
date-format-date=yyyy-MM-dd
date-format-time=HH:mm:ss

date-timezone=GMT+8:00

#number
number-format-currency=#,###.00

#password
password-format=●●●●●●

#pager - total, start(0-index), begin, end, count, limit, page, pages
pager-label-info=${top.begin}~${top.end}/全${top.total}件
pager-label-infoz=${top.begin}件~${top.end}件
pager-label-empty=-- 没有数据 --
pager-label-limit=显示件数：
pager-tooltip-prev=&lt; 上一页
pager-tooltip-next=下一页 &gt;
pager-tooltip-first=≪ 最前页
pager-tooltip-last=最后页 ≫

#listview - filters
listview-filters-caption=检索
listview-filters-label-addFilter=检索条件追加
listview-filters-button-query=检索
listview-filters-button-clear=清除
listview-filters-label-method=检索方法

listview-filter-bools=\
	"true":  "是", \
	"false": "否"

listview-filter-strings=\
	"mt": "包含", \
	"lm": "开头", \
	"rm": "结尾", \
	"ge": "大于", \
	"le": "小于", \
	"eq": "相同", \
	"ne": "不同"
#	, \
#	"lk": "相像", \
#	"nk": "不像"



#servlet error
servlet-error-title-404=网页不存在
servlet-error-title-403=禁止访问
servlet-error-title-500=服务器内部错误发生,网页无法显示。
servlet-error-title-503=服务器超负荷,网页无法显示。
servlet-error-message-404=指定的网页不存在。
servlet-error-message-403=没有权限访问指定的网页。
servlet-error-message-500=服务器内部错误，无法显示指定的网页。
servlet-error-message-503=服务器超负荷，无法显示指定的网页。\n\
请稍稍等待片刻之后重新访问网站。
servlet-error-request-url=请求网页: <span class="request-url">${top}</span>
servlet-error-exception=例外信息:



#validation error message
validation-alphanumericstring=请输入英数字。
validation-alphastring=请输入英文。
validation-binary-length=输入文字字数(${top.binSize})不正确。请输入\
${(top.minLength != null && top.maxLength != null) ? (top.minBinSize + "~" + top.maxBinSize + "以内") : \
(top.minLength != null ? (top.minBinSize + "以上") : \
(top.maxLength != null ? (top.maxBinSize + "以下") : ""))}\
的文字。
validation-cast=输入内容不正确。
validation-cast-boolean=请输入true或者false。
validation-cast-char=请输入字符。
validation-cast-date=请输入"yyyy/MM/dd"格式的日期。
validation-cast-decimal=请输入数字。
validation-cast-number=请输入整数字。
validation-cast-file=请选择文件。
validation-compare=该项目的内容必须${(top.comparator == "eq" ? "=" : \
(top.comparator == "le" ? "<" : \
(top.comparator == "lt" ? "<=" : \
(top.comparator == "ge" ? ">" : \
(top.comparator == "gt" ? "<" : "")))))}\
项目「${top.target}」。
validation-compare-daterange-to=「终了日期」必须大于「开始日期」。
validation-compare-numberrange-to=数字范围的设定不正确。
validation-constant=请选择${top.consts}中的内容。
validation-creditcardnumber=请按"XXXX-XXXX-XXXX-XXXX"的格式输入正确的信用卡号码。
validation-date-to=请输入開始日期之后的日期。
validation-date-range=请输入${(top.min != null && top.max != null) ? (top.min + "~" + top.max + "之内") : \
(top.min != null ? (top.min + "之后") : \
(top.max != null ? (top.max + "之前") : ""))}\
的日期。
validation-email=请按"user@domain.com"的格式输入电子邮件地址。
validation-email-notsame=电子邮件和确认电子邮件不一致。
validation-empty=该项目必须为空。
validation-faxnumber=请按"1234-5678-9999"的格式输入传真号码。
validation-filename=文件名中无法使用以下　\/:*?"<>|　文字。
validation-file-length=文件大小${top.fileSize}不正确。请指定\
${(top.minLength != null && top.maxLength != null) ? (top.minFileSize + "~" + top.maxFileSize + "以内") : \
(top.minLength != null ? (top.minFileSize + "以上") : \
(top.maxLength != null ? (top.maxFileSize + "以下") : ""))}\
的文件。
validation-futuredate=不允许输入未来的日期。
validation-hankakukatakanastring=请输入半角片假名。
validation-hankakustring=请输入半角文字。
validation-image=图像文件格式不正确。
validation-image-size=图像大小${top.width}x${top.height}不正确。请指定\
${(top.minWidth != null && top.maxWidth != null) ? ("宽" + top.minWidth + "~" + top.maxWidth + "以内") : \
(top.minWidth != null ? ("宽" + top.minWidth + "以上") : \
(top.maxWidth != null ? ("宽" + top.maxWidth + "以下") : ""))}\
${((top.minWidth != null || top.maxWidth != null) && (top.minHeight != null || top.maxHeight != null)) ? ", " : ""}\
${(top.minHeight != null && top.maxHeight != null) ? ("高" + top.minHeight + "~" + top.maxHeight + "以内") : \
(top.minHeight != null ? ("高" + top.minHeight + "以上") : \
(top.maxHeight != null ? ("高" + top.maxHeight + "以下") : ""))}\
的图像文件。
validation-incorrect=该项目内容不正确。
validation-locale-invalid=语言和国家・地区的组合不正确。
validation-number-range=请输入${(top.min != null && top.max != null) ? (top.min + "~" + top.max + "以内") : \
(top.min != null ? (top.min + "以上") : \
(top.max != null ? (top.max + "以下") : ""))}\
的数字。
validation-number-to=The number must be larger than start number.
validation-numericstring=请输入数字。
validation-password=密码必须输入英数字。
validation-password-notsame=输入密码和确认密码不一致。
validation-password-incorrect=密码错误。
validation-passeddate=不允许输入过去的日期。
validation-precision=请按"整数${top.precision - top.scale}.小数${top.scale}"的格式输入。
validation-prohibited=${top.consts}中的内容不可以输入。
validation-regex=该项目输入内容不符合正规表达式"${top.regex}"。
validation-required=请输入该项目内容。
validation-requiredfile=请指定上传文件。
validation-requiredimage=请指定上传图像文件。
validation-string-length=输入文字数：${top.length}。请输入\
${(top.minLength != null && top.maxLength != null) ? (top.minLength + "~" + top.maxLength + "个字符以内") : \
(top.minLength != null ? (top.minLength + "个字符以上") : \
(top.maxLength != null ? (top.maxLength + "个字符以下") : ""))}\
的文字。
validation-telnumber=请按"1234-5678-9999"的格式输入电话号码。
validation-url=请按"http://www.domain.com"的格式输入URL。
validation-zenkakustring=请输入全角文字。
validation-zenkakukatakanastring=请输入全角片假名。
validation-zipcode=请按"123-4567"的格式输入邮政编码。



#error messages
error-input=输入内容不正确。
error-input-detail=错误信息
error-data-notfound=该数据不存在。
error-data-duplicate=该数据已经被登录。\n${top}
error-data-incorrect=该数据内容不正确。\n${top}
error-fieldvalue-notnull=该项目必须为空。
error-fieldvalue-required=该项目不能为空。
error-fieldvalue-incorrect=该项目输入内容不正确。
error-fieldvalue-duplicate=该数据已经被登录。
error-file-notfound=该文件"${top}"不存在。


#customer error messages
error-unlogin=用户未登录!
error-unsecure=为了确保用户资料安全，请登陆。
error-nopermit=用户没有权限!
error-email-is-used=电子邮件地址已经被使用。
error-sendmail=电子邮件送信失敗。\n请确认电子邮件地址[${top}]是否正确。
error-file-upload=文件上传失敗。

#info messages
message-file-uploading=文件上传中...
message-processing=处理中...
message-processed=处理成功。

#tooltip
tooltip-add=追加
tooltip-cancel=取消
tooltip-copy=复写
tooltip-delete=删除
tooltip-edit=编辑
tooltip-insert=登录
tooltip-recover=恢复
tooltip-selectAll=全部选择
tooltip-selectNone=不选择任何项目
tooltip-trash=删除
tooltip-update=变更


#placeholder
placeholder-search=检索...

#text
text-copy-to-clipboard=拷贝至剪贴板


#button
button-add=追加
button-approve=批准
button-back=返回
button-cancel=取消
button-change=变更
button-clear=清除
button-close=关闭
button-confirm=确认
button-copy=复写
button-csv=CSV汇出
button-delete=删除
button-deny=否决
button-disable=无效
button-edit=编辑
button-enable=有効
button-exec=执行
button-execute=实行
button-home=主页
button-import=汇入
button-insert=追加
button-json=JSON汇出
button-layoutPC=PC版显示
button-layoutMB=手机版显示
button-list=浏览
button-login=登录
button-next=下一步
button-pdf=PDF打印
button-print=印刷画面
button-recover=恢复
button-refresh=刷新
button-reload=重新加载
button-reset=重置
button-save=保存
button-search=检索
button-selectAll=全部选择
button-selectNone=取消选择
button-send=送信
button-shopping=继续购物
button-signin=登录
button-status=状态
button-start=开始
button-start-all=全开始
button-status=状态
button-stop=停止
button-stop-all=全停止
button-submit=提交
button-toHome=返回主页
button-toLogin=登录画面
button-toSignin=登录画面
button-trash=删除
button-update=修改
button-view=显示
button-xml=XML汇出


#title
title-error=错误
title-reload=${top}「重新加载确认」
title-reloaded=${top}「重新加载结果」

