#########################################################################
# application resource
#########################################################################
#navigation
navi-top=TOP
navi-home=Home

navi-search=Search
navi-tag=Tag
navi-theme=Theme
navi-language=Languages

navi-help=Help
navi-help-contact=Contact
navi-help-privacy=Privacy
navi-help-termsofuse=Terms of use
navi-help-payment=Payment
navi-help-ship=Ship


navi-user=My Account
navi-user-register=Register
navi-user-login=Login
navi-user-logout=Logout
navi-user-signin=Sign in
navi-user-signout=Sign out

navi-user-account=Account
navi-user-passwordchange=Password change
navi-user-profile=Profile


navi-admin=Administration
navi-admin-account=Account
navi-admin-account-user=User
navi-admin-account-usergroup=User Group

navi-admin-site=Site
navi-admin-site-category=Category
navi-admin-site-index=Search Index

navi-admin-system=System
navi-admin-system-loadtask=Cache
navi-admin-system-property=Property
navi-admin-system-resource=Resource
navi-admin-system-template=Template
navi-admin-system-cronjobs=Cron Jobs
navi-admin-system-dataimp=Data Import
navi-admin-system-html2pdf=HTML->PDF
navi-admin-system-ndfsfile=NDFS Tool
navi-admin-system-eleval=EL Tool
navi-admin-system-sqlexec=SQL Tool


#reload
message-property-updated=The property has been updated.\nPlease <a href="${base}/admin/loadtask">reload property</a> to apply the changes.
message-resource-updated=The resource has been updated.\nPlease <a href="${base}/admin/loadtask">reload resource</a> to apply the changes.
message-template-updated=The template has been updated.\nPlease <a href="${base}/admin/loadtask">reload template</a> to apply the changes.

#label
label-page-size=Page Size:
label-sort=Sort:
label-attachment=Attachment
label-search-result=Search result of "${top.key}"


#tip
tip-access=Access Count
tip-voteup=Good
tip-votedn=Bad
tip-bookmark=Bookmark


#d.statusMap
data-statusMap=\
	"0": "Enbaled", \
	"X": "Disabled"


#locale
locale-languages=\
	"*": "*", \
	"en": "English", \
	"ja": "Japanese", \
	"zh": "Chinese"

locale-countries=\
	"*": "*", \
	"JP": "Japan", \
	"CN": "China"


#const
const-bloodTypes="A", "O", "B", "AB"

const-booleans=\
	"true": "YES", \
	"false": "NO"
	
const-genders=\
	"F": "Female", \
	"M": "Male"

